==================================
CLASS
==================================
SparkFun_Bio_Sensor_Hub	KEYWORD1

==================================
FUNCTIONS
==================================
begin	KEYWORD2
beginBootloader	KEYWORD2
readSensorHubStatus	KEYWORD2
setOperatingMode	KEYWORD2
configBpm	KEYWORD2
configSensor	KEYWORD2
configSensorBpm	KEYWORD2
readBpm	KEYWORD2
readSensor	KEYWORD2
readSensorBpm	KEYWORD2
setPulseWidth	KEYWORD2
readPulseWidth	KEYWORD2
setSampleRate	KEYWORD2
readSampleRate	KEYWORD2
setAdcRange	KEYWORD2
readAdcRange	KEYWORD2
getMcuType	KEYWORD2
getBootloaderInf	KEYWORD2
max30101Control	KEYWORD2
readMAX30101State	KEYWORD2
accelControl	KEYWORD2
setOutputMode	KEYWORD2
setFifoThreshold	KEYWORD2
numSamplesOutFifo	KEYWORD2
getDataOutFifo	KEYWORD2
numSamplesExternalSensor	KEYWORD2
writeRegisterMAX30101	KEYWORD2
writeRegisterAccel	KEYWORD2
readRegisterMAX30101	KEYWORD2
readRegisterAccel	KEYWORD2
getAfeAttributesMAX30101	KEYWORD2
getAfeAttributesAccelerometer	KEYWORD2
dumpRegisterMAX30101	KEYWORD2
dumpRegisterAccelerometer	KEYWORD2
setAlgoRange	KEYWORD2
setAlgoStepSize	KEYWORD2
setAlgoSensitivity	KEYWORD2
setAlgoSamples	KEYWORD2
setMaximFastCoef	KEYWORD2
readAlgoRange	KEYWORD2
readAlgoStepSize	KEYWORD2
readAlgoSensitivity	KEYWORD2
readAlgoSamples	KEYWORD2
readMaximFastCoef	KEYWORD2
agcAlgoControl	KEYWORD2
maximFastAlgoControl	KEYWORD2
setNumPages	KEYWORD2
eraseFlash	KEYWORD2
readBootloaderVers	KEYWORD2
readSensorHubVersion	KEYWORD2
readAlgorithmVersion	KEYWORD2

==================================
CONSTANTS
==================================
WRITE_FIFO_INPUT_BYTE	LITERAL1
DISABLE	LITERAL1
ENABLE	LITERAL1
MODE_ONE	LITERAL1
MODE_TWO	LITERAL1
APP_MODE	LITERAL1
BOOTLOADER_MODE	LITERAL1
NO_WRITE	LITERAL1
INCORR_PARAM	LITERAL1
CONFIGURATION_REGISTER	LITERAL1
PULSE_MASK	LITERAL1
READ_PULSE_MASK	LITERAL1
SAMP_MASK	LITERAL1
READ_SAMP_MASK	LITERAL1
ADC_MASK	LITERAL1
READ_ADC_MASK	LITERAL1
ENABLE_CMD_DELAY	LITERAL1
CMD_DELAY	LITERAL1
MAXFAST_ARRAY_SIZE	LITERAL1
MAXFAST_EXTENDED_DATA	LITERAL1
MAX30101_LED_ARRAY	LITERAL1
SET_FORMAT	LITERAL1
READ_FORMAT	LITERAL1
WRITE_SET_THRESHOLD	LITERAL1
WRITE_EXTERNAL_TO_FIFO	LITERAL1
SUCCESS	LITERAL1
ERR_UNAVAIL_CMD	LITERAL1
ERR_UNAVAIL_FUNC	LITERAL1
ERR_DATA_FORMAT	LITERAL1
ERR_INPUT_VALUE	LITERAL1
ERR_TRY_AGAIN	LITERAL1
ERR_BTLDR_GENERAL	LITERAL1
ERR_BTLDR_CHECKSUM	LITERAL1
ERR_BTLDR_AUTH	LITERAL1
ERR_BTLDR_INVALID_APP	LITERAL1
ERR_UNKNOWN	LITERAL1
HUB_STATUS	LITERAL1
SET_DEVICE_MODE	LITERAL1
READ_DEVICE_MODE	LITERAL1
OUTPUT_MODE	LITERAL1
READ_OUTPUT_MODE	LITERAL1
READ_DATA_OUTPUT	LITERAL1
READ_DATA_INPUT	LITERAL1
WRITE_INPUT	LITERAL1
WRITE_REGISTER	LITERAL1
READ_REGISTER	LITERAL1
READ_ATTRIBUTES_AFE	LITERAL1
DUMP_REGISTERS	LITERAL1
ENABLE_SENSOR	LITERAL1
READ_SENSOR_MODE	LITERAL1
CHANGE_ALGORITHM_CONFIG	LITERAL1
READ_ALGORITHM_CONFIG	LITERAL1
ENABLE_ALGORITHM	LITERAL1
BOOTLOADER_FLASH	LITERAL1
BOOTLOADER_INFO	LITERAL1
IDENTITY	LITERAL1
EXIT_BOOTLOADER	LITERAL1
RESET	LITERAL1
ENTER_BOOTLOADER	LITERAL1
PAUSE	LITERAL1
SENSOR_DATA	LITERAL1
ALGO_DATA	LITERAL1
SENSOR_AND_ALGORITHM	LITERAL1
PAUSE_TWO	LITERAL1
SENSOR_COUNTER_BYTE	LITERAL1
ALGO_COUNTER_BYTE	LITERAL1
SENSOR_ALGO_COUNTER	LITERAL1
NUM_SAMPLES	LITERAL1
READ_DATA	LITERAL1
SAMPLE_SIZE	LITERAL1
READ_INPUT_DATA	LITERAL1
READ_SENSOR_DATA	LITERAL1
READ_NUM_SAMPLES_INPUT	LITERAL1
READ_NUM_SAMPLES_SENSOR	LITERAL1
WRITE_MAX30101	LITERAL1
WRITE_ACCELEROMETER	LITERAL1
READ_MAX30101	LITERAL1
READ_ACCELEROMETER	LITERAL1
RETRIEVE_AFE_MAX30101	LITERAL1
RETRIEVE_AFE_ACCELEROMETER	LITERAL1
DUMP_REGISTER_MAX30101	LITERAL1
DUMP_REGISTER_ACCELEROMETER	LITERAL1
ENABLE_MAX30101	LITERAL1
ENABLE_ACCELEROMETER	LITERAL1
READ_ENABLE_MAX30101	LITERAL1
READ_ENABLE_ACCELEROMETER	LITERAL1
SET_TARG_PERC	LITERAL1
SET_STEP_SIZE	LITERAL1
SET_SENSITIVITY	LITERAL1
SET_AVG_SAMPLES	LITERAL1
SET_PULSE_OX_COEF	LITERAL1
AGC_GAIN_ID	LITERAL1
AGC_STEP_SIZE_ID	LITERAL1
AGC_SENSITIVITY_ID	LITERAL1
AGC_NUM_SAMP_ID	LITERAL1
MAXIMFAST_COEF_ID	LITERAL1
READ_AGC_PERCENTAGE	LITERAL1
READ_AGC_STEP_SIZE	LITERAL1
READ_AGC_SENSITIVITY	LITERAL1
READ_AGC_NUM_SAMPLES	LITERAL1
READ_MAX_FAST_COEF	LITERAL1
READ_AGC_PERC_ID	LITERAL1
READ_AGC_STEP_SIZE_ID	LITERAL1
READ_AGC_SENSITIVITY_ID	LITERAL1
READ_AGC_NUM_SAMPLES_ID	LITERAL1
READ_MAX_FAST_COEF_ID	LITERAL1
ENABLE_AGC_ALGO	LITERAL1
ENABLE_WHRM_ALGO	LITERAL1
SET_INIT_VECTOR_BYTES	LITERAL1
SET_AUTH_BYTES	LITERAL1
SET_NUM_PAGES	LITERAL1
ERASE_FLASH	LITERAL1
SEND_PAGE_VALUE	LITERAL1
BOOTLOADER_VERS	LITERAL1
PAGE_SIZE	LITERAL1
READ_MCU_TYPE	LITERAL1
READ_SENSOR_HUB_VERS	LITERAL1
READ_ALGO_VERS	LITERAL1

==================================
DATA TYPES
==================================
READ_STATUS_BYTE_VALUE	KEYWORD1
FAMILY_REGISTER_BYTES	KEYWORD1
DEVICE_MODE_WRITE_BYTES	KEYWORD1
OUTPUT_MODE_WRITE_BYTE	KEYWORD1
FIFO_OUTPUT_INDEX_BYTE	KEYWORD1
FIFO_EXTERNAL_INDEX_BYTE	KEYWORD1
WRITE_REGISTER_INDEX_BYTE	KEYWORD1
READ_REGISTER_INDEX_BYTE	KEYWORD1
GET_AFE_INDEX_BYTE	KEYWORD1
DUMP_REGISTER_INDEX_BYTE	KEYWORD1
SENSOR_ENABLE_INDEX_BYTE	KEYWORD1
READ_SENSOR_ENABLE_INDEX_BYTE	KEYWORD1
ALGORITHM_CONFIG_INDEX_BYTE	KEYWORD1
ALGO_AGC_WRITE_BYTE	KEYWORD1
READ_ALGORITHM_INDEX_BYTE	KEYWORD1
READ_AGC_ALGO_WRITE_BYTE	KEYWORD1
ALGORITHM_MODE_ENABLE_INDEX_BYTE	KEYWORD1
BOOTLOADER_FLASH_INDEX_BYTE	KEYWORD1
BOOTLOADER_INFO_INDEX_BYTE	KEYWORD1
IDENTITY_INDEX_BYTES	KEYWORD1
